77 77 77 77 77 77 77 77 77 77 77 77 77 77 77 77 77 77 77 77 77 77 77 77 77 77 77 77 77 77 77 77 77 77 77 77 77 77 77 77 77 77 77 77 77 77 77 77 77 77 
77 77 77 77 77 77 77 77 77 77 77 77 77 77 77 77 77 77 77 77 77 77 77 77 77 77 77 77 77 77 77 77 77 77 77 77 77 77 77 77 77 77 77 77 77 77 77 77 77 77 
77 77 77 77 77 77 77 77 77 77 77 77 77 77 77 77 77 77 77 77 77 77 77 77 77 77 77 77 77 77 77 77 77 77 77 77 77 77 77 77 77 77 77 77 77 77 77 77 77 77 
77 77 77 77 77 77 77 19 18 18 18 18 18 18 18 18 18 18 18 18 18 18 18 18 18 18 18 18 18 18 18 18 57 55 51 51 51 51 51 51 51 51 51 51 51 51 57 77 77 77 
77 77 77 77 77 77 19 20 13 12 13 13 12 12 13 12 13 13 13 13 12 13 12 13 12 13 12 12 13 12 12 32 58 56 43 42 42 42 42 42 42 42 42 42 42 40 50 77 77 77 
77 77 77 77 77 77 16 14 13 11 11 11 11 11 11 11 11 11 11 11 11 11 11 11 11 11 11 11 11 11 11 29 25 25 25 25 25 25 25 25 25 25 25 25 25 40 50 77 77 77 
77 77 77 77 77 19 20 13 11 73 60 64 63 63 60 67 73 59 59 60 64 63 59 59 63 59 63 63 59 64 67 29 25 25 25 25 25 25 25 25 25 25 25 25 25 40 50 77 77 77 
77 77 77 77 77 16 14 13 11 65 11 11 11 82 83 11 61 11 11 11 11 11 11 11 11 11 11 11 11 11 11 29 25 25 25 25 25 25 25 25 25 25 25 25 25 40 50 77 77 77 
77 77 77 77 19 20 14 13 11 69 11 11 11 17 16 11 62 11 12 12 11 79 46 46 46 46 46 46 46 46 46 46 46 80 39 25 25 25 25 25 40 79 80 39 25 40 50 77 77 77 
77 77 77 77 16 14 13 13 11 73 60 74 11 17 16 11 66 11 13 12 11 50 55 51 51 51 51 51 51 51 51 51 51 56 39 25 25 25 25 25 40 50 49 39 25 40 50 77 77 77 
77 77 77 19 20 14 11 11 11 61 14 62 11 17 16 11 66 11 13 13 11 50 49 43 42 42 42 42 42 42 42 42 42 42 25 25 25 25 25 25 40 50 49 39 25 40 50 77 77 77 
77 77 77 16 14 11 11 73 67 71 64 72 11 22 20 11 66 11 13 12 11 50 49 39 25 25 25 25 25 25 25 25 25 25 25 25 25 25 25 25 40 50 49 39 25 40 50 77 77 77 
77 77 77 16 14 11 11 66 11 11 11 11 11 11 11 11 61 11 12 13 11 50 49 39 25 25 25 25 25 25 25 25 25 25 25 79 46 46 46 46 46 48 49 39 25 40 50 77 77 77 
77 77 77 16 14 11 11 65 11 13 13 11 70 60 63 67 66 11 12 12 11 50 49 39 25 25 25 25 25 25 25 25 25 25 25 58 51 51 51 51 51 51 56 39 25 40 50 77 77 77 
77 77 77 87 84 84 83 62 11 81 85 85 85 88 11 11 65 11 12 13 11 50 49 39 25 25 25 25 25 25 25 25 25 25 25 42 42 42 42 42 42 42 42 25 25 40 50 77 77 77 
77 77 77 77 77 19 20 61 11 12 14 14 14 14 13 11 65 11 12 13 11 50 49 39 25 25 25 25 25 25 25 25 25 25 25 25 25 25 25 25 25 25 25 25 25 40 50 77 77 77 
77 77 77 77 77 16 11 61 11 13 13 13 13 14 12 11 65 11 12 13 11 50 49 39 25 25 25 25 25 25 25 25 25 25 25 25 25 25 25 25 25 25 25 25 25 79 48 77 77 77 
77 77 77 77 77 16 11 65 11 11 11 11 12 14 13 11 62 11 12 12 11 50 47 46 46 46 46 46 46 46 80 25 25 25 25 25 25 79 46 46 46 46 46 46 46 48 55 51 51 51 
77 77 77 77 77 16 11 71 64 63 74 11 13 14 13 11 61 13 13 12 11 58 51 51 51 51 51 51 51 51 56 25 25 25 25 25 25 58 51 51 51 51 51 51 51 51 56 36 36 36 
77 77 77 77 19 20 13 11 11 11 65 11 12 14 13 11 66 11 13 12 11 11 11 11 11 11 11 11 11 11 27 26 26 26 26 26 26 28 11 11 11 11 11 11 11 11 11 75 75 75 
77 77 77 77 16 14 14 12 13 11 65 11 13 14 13 11 66 11 13 12 13 13 12 13 13 11 12 13 12 13 12 12 13 12 68 11 12 12 12 13 12 12 13 12 13 12 13 75 75 75 
77 77 77 77 16 14 14 13 12 11 62 11 12 14 12 11 65 11 11 11 11 11 11 11 11 11 11 11 11 11 11 11 11 11 62 11 11 11 11 11 11 11 11 11 11 11 11 75 75 75 
77 77 77 77 16 14 14 14 13 11 61 11 13 13 13 11 69 70 63 64 64 64 59 59 59 60 60 64 60 64 63 63 63 64 72 11 11 70 63 64 60 63 63 74 70 63 64 75 75 75 
77 77 77 77 16 14 14 14 13 11 66 11 11 11 11 11 68 11 11 11 11 11 11 68 11 11 11 11 11 11 11 11 11 11 11 11 11 11 11 11 11 11 11 62 11 11 11 75 75 75 
77 77 77 19 20 14 14 14 13 11 71 63 63 59 67 70 72 11 12 12 13 12 11 65 11 12 12 12 12 12 11 11 11 13 13 12 13 13 13 13 13 12 11 65 11 12 12 75 75 75 
77 77 77 16 14 14 14 14 13 13 11 11 11 11 11 11 11 11 12 12 12 13 11 61 11 12 12 13 12 14 14 14 14 14 14 14 14 14 14 12 13 13 11 61 11 13 13 75 75 75 
77 77 77 16 14 14 14 14 14 14 13 13 13 13 11 12 12 12 12 13 12 12 11 66 11 12 13 13 14 14 14 14 14 14 14 14 14 14 14 14 14 13 11 61 11 13 12 75 75 75 
77 77 77 16 14 14 14 14 14 14 14 14 12 13 12 12 13 12 12 12 13 13 11 66 11 12 13 13 14 14 14 14 14 14 14 14 14 14 14 14 14 13 11 62 11 11 12 75 75 75 
77 77 77 16 14 14 14 12 12 13 14 14 14 14 13 13 12 13 13 12 12 12 11 61 11 13 13 13 14 14 14 14 14 14 14 14 14 14 14 14 12 11 11 66 11 13 11 75 75 75 
77 77 77 16 14 14 13 13 12 13 13 14 14 14 82 83 12 13 13 12 13 12 11 62 11 12 13 14 14 14 14 14 14 14 14 12 14 14 14 13 13 11 11 65 11 13 12 75 75 75 
77 77 77 16 14 14 13 13 13 13 13 13 14 14 17 16 12 13 12 12 13 12 11 65 11 11 12 14 14 14 14 14 14 14 13 13 13 13 13 13 11 11 11 65 11 12 13 75 75 75 
77 77 77 16 14 13 13 12 13 13 13 12 13 14 17 16 13 12 12 13 13 12 11 65 11 12 14 14 14 14 14 14 12 12 13 11 11 11 11 11 11 11 11 69 11 11 11 75 75 75 
77 77 77 16 14 12 13 12 12 13 12 13 12 14 17 16 12 13 12 13 13 12 11 66 11 12 14 14 14 14 14 14 13 13 11 9 8 8 8 8 8 8 10 9 8 8 10 75 75 75 
77 77 77 16 14 14 14 13 13 13 13 13 14 14 17 16 13 13 13 12 12 12 11 66 11 12 12 14 14 14 14 12 12 11 11 6 2 2 2 2 2 2 7 6 2 2 7 75 75 75 
77 77 77 16 14 14 14 14 14 14 14 14 14 14 17 16 13 12 12 12 13 13 11 61 11 12 12 14 14 14 12 12 11 11 11 6 2 2 2 2 2 2 7 6 2 2 7 75 75 75 
77 77 77 87 84 84 84 84 84 84 84 84 84 84 86 87 84 84 83 12 13 12 11 62 11 12 12 13 13 13 13 12 11 6 2 2 2 2 2 2 2 2 7 6 2 2 7 75 75 75 
18 18 18 18 18 18 18 18 18 18 18 21 77 77 19 18 18 18 20 12 12 13 11 65 11 13 13 12 13 13 12 13 11 6 2 2 2 2 2 2 2 2 7 6 2 2 7 75 75 75 
36 36 36 14 14 14 14 14 14 14 14 17 77 77 16 13 12 12 11 11 11 11 11 65 11 11 11 11 11 11 11 11 11 6 2 2 2 2 2 2 2 2 7 6 2 2 7 75 75 75 
75 75 75 14 14 11 11 11 11 14 14 17 77 77 16 12 12 13 11 73 63 67 11 71 59 60 60 64 63 63 67 11 11 4 3 3 3 3 3 3 3 3 5 4 3 3 5 75 75 75 
75 75 75 14 14 11 23 24 11 14 14 17 77 77 16 12 13 13 11 65 11 11 12 11 11 11 11 11 11 11 11 11 11 9 8 8 8 8 8 8 8 8 10 9 8 8 8 75 75 75 
75 75 75 14 14 11 11 11 11 11 14 22 18 18 20 13 11 11 11 69 11 13 12 13 12 12 12 12 12 13 13 11 11 6 2 2 2 2 2 2 2 2 7 6 2 2 0 75 75 75 
75 75 75 14 14 11 11 11 11 11 11 14 14 14 13 11 73 67 11 11 12 13 12 12 12 12 13 13 12 12 12 12 11 6 2 2 2 2 2 2 2 2 7 6 0 0 0 75 75 75 
75 75 75 15 14 11 23 11 11 24 11 14 14 14 13 70 72 11 12 13 13 13 13 13 12 12 12 12 13 12 12 13 11 11 6 2 2 2 2 2 0 0 7 15 1 1 1 75 75 75 
75 75 75 75 15 14 11 11 11 11 14 14 14 14 13 11 11 13 15 15 15 15 15 15 11 12 13 13 12 12 12 12 13 11 6 2 2 2 0 0 1 1 15 75 75 75 75 75 75 75 
75 75 75 75 75 14 14 11 24 11 14 14 14 14 14 13 13 15 75 75 75 75 75 75 15 11 12 13 12 12 12 13 12 11 6 2 0 0 1 1 75 75 75 75 75 75 75 75 75 75 
75 75 75 75 75 15 15 15 15 15 14 14 14 14 14 14 15 75 75 75 75 75 75 75 75 15 11 11 11 13 11 11 11 11 4 3 1 1 75 75 75 75 75 75 75 75 75 75 75 75 
75 75 75 75 75 75 75 75 75 75 15 15 15 15 15 15 75 75 75 75 75 75 75 75 75 75 15 15 15 15 15 15 15 15 15 15 75 75 75 75 75 75 75 75 75 75 75 75 75 75 
75 75 75 75 75 75 75 75 75 75 75 75 75 75 75 75 75 75 75 75 75 75 75 75 75 75 75 75 75 75 75 75 75 75 75 75 75 75 75 75 75 75 75 75 75 75 75 75 75 75 
75 75 75 75 75 75 75 75 75 75 75 75 75 75 75 75 75 75 75 75 75 75 75 75 75 75 75 75 75 75 75 75 75 75 75 75 75 75 75 75 75 75 75 75 75 75 75 75 75 75 
75 75 75 75 75 75 75 75 75 75 75 75 75 75 75 75 75 75 75 75 75 75 75 75 75 75 75 75 75 75 75 75 75 75 75 75 75 75 75 75 75 75 75 75 75 75 75 75 75 75